####################
#   #              #
#   #         ##   #
#   ####   #  ##   #
#         ##  ##   #
#             ##   #
#   ####      ##   #
#      #   ####    #
#      #   #       #
###    #####       #
#              #####
#                  #
#  ###    ###      #
#  ###    ###      #
#  ###    ###      #
#    ######        #
#  P          ######
####################